NetHack Sokoban 1b

┌────┐  ┌───┐ 
│····│  │···│ 
│·0··└──┘·0·│ 
│·0······0··│ 
│··┌─┐@┌─┐0·│ 
├──┴─┴─┼─┘·─┴┐
│··^^^<│·····│
│··┌───┤0····│
└┐^│   │·0···│
 │^└───┘·0···│
 │··^^^^0·0··│
 │??┌────────┘
 └──┘         
