NetHack Sokoban 2a

 ┌──┐          ┌─────────┐
┌┘·@└──────┐   │·········│
│··········│   │·········│
│·0┌───┐0─·│   │·········│
│··│···│·0·│   │····<····│
│·0·0····0─┤   │·········│
│·0··0··│··│   │·········│
│·────0·└┐·│   │·········│
│··0···0·│·└┐  │·········│
│·──┬0─···0·└──┴────────+┤
│···│··0─·0·^^^^^^^^^^^^·│
│··0······┌──────────────┘
└───┐··│··│               
    └──┴──┘               
